1111111111111111111111111111111111
100000000000000C00000C000000000001
10100101001000001010010000E0010101
1010010010101010000001000000010101
10000P000C00C0000000000000000000C1
1111111111111111111111111111111111
