11111111111111
1C01000C0001C1
10000111110101
10P011E0000001
11111111111111