11111111111111
1001000C0001C1
11110111110101
10P001E0000001
11111111111111